#municipis valencians en què el nom oficial difereix del nom valencià
Ademús=Ademuz
Aiòder=Ayódar
Aiora=Ayora
Alboraig=Alborache
Albuixec=Albuixech
Alcosser de Planes=Alcocer de Planes
Alfarb=Alfarp
Algar de Palància=Algar de Palancia
Algímia d'Almonesir=Algimia de Almonacid
Algímia d'Alfara=Algimia de Alfara
Almedíxer=Almedíjar
Alpont=Alpuente
Aranyel=Arañuel
Ares dels Oms=Aras de los Olmos
Argeleta=Argelita
Asp=Aspe
Assuévar=Azuébar
Barraques=Barracas
Begís=Bejís
Bell-lloc=Benlloch
Benaixeve=Benagéber
Benejússer=Benejúzar
Beniardà=Beniardá
Beniflà=Beniflá
Benijòfar=Benijófar
Bicorb=Bicorp
Bigastre=Bigastro
Bolbait=Bolbaite
Bunyol=Buñol
Cases Altes=Casas Altas
Cases Baixes=Casas Bajas
Castellnou=Castellnovo
Vilanova de Castelló=Villanueva de Castellón
Castelló de la Ribera=Villanueva de Castellón
Cervera del Maestrat=Cervera del Maestre
Cofrents=Cofrentes
Coix=Cox
Cortes d'Arenós=Cortes de Arenoso
Cortes de Pallars=Cortes de Pallás
Daia Nova=Daya Nueva
Daia Vella=Daya Vieja
Dolors=Dolores
Domenyo=Domeño
Dosaigües=Dos Aguas
el Castell de Vilamalefa=Castillo de Villamalefa
el Fondó dels Frares=Hondón de los Frailes
el Ràfol de Salem=Ráfol de Salem
el Vilar=Villar del Arzobispo
Énguera=Enguera
Espadella=Espadilla
Fageca=Facheca
Figueres=Higueras
Figueroles de Domenyo=Higueruelas
Gàtova=Gátova
Herbers=Herbés
Iàtova=Yátova
l'Alcúdia de Veo=Alcudia de Veo
l'Alguenya=Algueña
la Canyada=Cañada
la Iessa=La Yesa
la Llosa del Bisbe=Losa del Obispo
la Pobla d'Arenós=Puebla de Arenoso
la Pobla de Sant Miquel=Puebla de San Miguel
la Serra d'en Galceran=Sierra Engarcerán
la Vall d'Almonesir=Vall de Almonacid
les Alcubles=Alcublas
les Fonts d'Aiòder=Fuentes de Ayódar
les Salines=Salinas
Lludient=Ludiente
Millars=Millares
Monfort=Monforte del Cid
Montant=Montán
Montcada=Moncada
Muro d'Alcoi=Muro de Alcoy
Nàquera=Náquera
Navaixes=Navajas
Olocau del Rei=Olocau del Rey
Oriola=Orihuela
Pavies=Pavías
Pilar de la Foradada=Pilar de la Horadada
Pina=Pina de Montalgrao
Redovà=Redován
Rojals=Rojales
Ròtova=Rótova
Sacanyet=Sacañet
Saix=Sax
Sanet i els Negrals=Sanet y Negrals
Sant Antoni de Benaixeve=San Antonio de Benagéber
Sant Fulgenci=San Fulgencio
Sant Isidre=San Isidro
Sant Miquel de les Salines=San Miguel de Salinas
Sant Rafel del Riu=San Rafael del Río
Santa Magdalena de Polpís=Santa Magdalena de Pulpis
Setaigües=Siete Aguas
Sinarques=Sinarcas
Sogorb=Segorbe
Sorita=Zorita del Maestrazgo
Sot de Xera=Sot de Chera
Sucaina=Zucaina
Teresa de Cofrents=Teresa de Cofrentes
Titaigües=Titaguas
Toixa=Tuéjar
Toràs=Torás
Torís=Turís
Torre Baixa=Torrebaja
Torre-xiva=Torrechiva
Torrevella=Torrevieja
Vilafermosa=Villahermosa del Río
Vilamalur=Villamalur
Vilanova de la Reina=Villanueva de Viver
Xacarella=Jacarilla
Xalans=Jalance
Xarafull=Jarafuel
Xella=Chella
Xelva=Chelva
Xera=Chera
Xèrica=Jérica
Xest=Cheste
Xestalgar=Gestalgar
Xiva=Chiva
Xóvar=Chóvar
Xulilla=Chulilla
